Acrobatic	summary: "+2 bonus on Acrobatics and Fly checks",
Agile Maneuvers	summary: "Use your Dex bonus when calculating your CMB",
Alertness	summary: "+2 bonus on Perception and Sense Motive checks",
Alignment Channel	summary: "Channel energy can heal or harm outsiders",
Animal Affinity	summary: "+2 bonus on Handle Animal and Ride checks",
Arcane Armor Training	summary: "Reduce your arcane spell failure chance by 10%",
Arcane Armor Mastery	summary: "Reduce your arcane spell failure chance by 20%",
Arcane Strike	summary: "+1 damage and weapons are considered magic",
Armor Proficiency, Light	summary: "No penalties on attack rolls while wearing light armor",
Armor Proficiency, Medium	summary: "No penalties on attack rolls while wearing medium armor",
Armor Proficiency, Heavy	summary: "No penalties on attack rolls while wearing heavy armor",
Athletic	summary: "+2 bonus on Climb and Swim checks",
Augment Summoning	summary: "Summoned creatures gain +4 Str and Con",
Blind-Fight	summary: "Reroll miss chances for concealment",
Catch Off-Guard	summary: "No penalties for improvised melee weapons",
Channel Smite	summary: "Channel energy through your attack",
Combat Casting	summary: "+4 bonus on concentration checks for defensive casting",
Combat Expertise	summary: "Trade attack bonus for AC bonus",
Improved Disarm	summary: "+2 bonus on disarm attempts, no attack of opportunity",
Greater Disarm	summary: "Disarmed weapons are knocked away from your enemy",
Improved Feint	summary: "Feint as a move action",
Greater Feint	summary: "Enemies you feint lose their Dex bonus for 1 round",
Improved Trip	summary: "+2 bonus on trip attempts, no attack of opportunity",
Greater Trip	summary: "Enemies you trip provoke attacks of opportunity",
Whirlwind Attack	summary: "Make one melee attack against all foes within reach ",
Combat Reflexes	summary: "Make additional attacks of opportunity",
Stand Still	summary: "Stop enemies from moving past you",
Command Undead	summary: "Channel energy can be used to control undead",
Critical Focus	summary: "+4 bonus on attack rolls made to confirm critical hits",
Bleeding Critical	summary: "Whenever you score a critical hit, the target takes 2d6 bleed",
Blinding Critical	summary: "Whenever you score a critical hit, the target is blinded",
Critical Mastery	summary: "Apply two effects to your critical hits",
Deafening Critical	summary: "Whenever you score a critical hit, the target is deafened",
Sickening Critical	summary: "Whenever you score a critical hit, the target is sickened",
Staggering Critical	summary: "Whenever you score a critical hit, the target is staggered",
Stunning Critical	summary: "Whenever you score a critical hit, the target is stunned",
Tiring Critical	summary: "Whenever you score a critical hit, the target is fatigued",
Exhausting Critical	summary: "Whenever you score a critical hit, the target is exhausted",
Deadly Aim	summary: "Trade ranged attack bonus for damage",
Deceitful	summary: "+2 bonus on Bluff and Disguise checks",
Defensive Combat Training	summary: "Use your total Hit Dice as your base attack bonus for CMD",
Deft Hands	summary: "+2 bonus on Disable Device and Sleight of Hand checks",
Disruptive	summary: "Increases the DC to cast spells adjacent to you",
Spellbreaker	summary: "Enemies provoke attacks if their spells fail",
Dodge	summary: "+1 dodge bonus to AC",
Mobility	summary: "+4 AC against attacks of opportunity from movement",
Spring Attack	summary: "Move before and after melee attack",
Wind Stance	summary: "Gain 20% concealment if you move",
Lightning Stance	summary: "Gain 50% concealment if you move",
Elemental Channel	summary: "Channel energy can harm or heal elementals",
Endurance	summary: "+4 bonus on checks to avoid nonlethal damage",
Diehard	summary: "Automatically stabilize and remain conscious below 0 hp",
Eschew Materials	summary: "Cast spells without material components",
Exotic Weapon Proficiency	summary: "No penalty on attacks made with one exotic weapon",
Extra Channel	summary: "Channel energy two additional times per day",
Extra Ki	summary: "Increase your ki pool by 2 points",
Extra Lay On Hands	summary: "Use lay on hands two additional times per day",
Extra Mercy	summary: "Your lay on hands benefits from one additional mercy",
Extra Performance	summary: "Use bardic performance for 6 additional rounds per day",
Extra Rage	summary: "Use rage for 6 additional rounds per day",
Fleet	summary: "Your base speed increases by 5 feet",
Great Fortitude	summary: "+2 on Fortitude saves",
Improved Great Fortitude	summary: "Once per day, you may reroll a Fortitude save",
Improved Channel	summary: "+2 bonus on channel energy DC",
Improved Counterspell	summary: "Counterspell with spell of the same school",
Improved Critical	summary: "Double the threat range of one weapon ",
Improved Familiar	summary: "Gain a more powerful familiar",
Improved Initiative	summary: "+4 bonus on initiative checks",
Improved Unarmed Str ke	summary: "Always considered armed",
Deflect Arrows	summary: "Avoid one ranged attack per round",
Snatch Arrows	summary: "Catch one ranged attack per round",
Improved Grapple	summary: "+2 bonus on grapple attempts, no attack of opportunity",
Greater Grapple	summary: "Maintain your grapple as a move action",
Scorpion Style	summary: "Reduce target’s speed to 5 ft.",
Gorgon’s Fist	summary: "Stagger a foe whose speed is reduced",
Medusa’s Wrath	summary: "Make 2 extra attacks against a hindered foe",
Stunning Fist	summary: ", Stun opponent with an unarmed strike ",
Improvised Weapon Mastery	summary: "Make an improvised weapon deadly ",
Intimidating Prowess	summary: "Add Str to Intimidate in addition to Cha",
Iron Will	summary: "+2 bonus on Will saves",
Improved Iron Will	summary: "Once per day, you may reroll a W ll save",
Leadership	summary: "Gain a cohort and followers",
Lightning Reflexes	summary: "+2 bonus on Reflex saves",
Improved Lightning Reflexes	summary: "Once per day, you may reroll a Reflex save",
Lunge	summary: "Take a –2 penalty to your AC to attack with reach",
Magical Aptitude	summary: "+2 bonus on Spellcraft and Use Magic Device checks",
Martial Weapon Proficiency	summary: "No penalty on attacks made with one martial weapon",
Master Craftsman	summary: "You can craft magic items without being a spellcaster",
Mounted Combat	summary: "Avoid attacks on mount with Ride check",
Mounted Archery	summary: "Halve the penalty for ranged attacks while mounted",
Ride-By Attack	summary: "Move before and after a charge attack while mounted",
Spirited Charge	summary: "Double damage on a mounted charge",
Trample	summary: "Overrun targets while mounted",
Unseat	summary: "Knock opponents from their mounts",
Natural Spell	summary: "Cast spells while using wild shape",
Nimble Moves	summary: "Ignore 5 feet of difficult terrain when you move",
Acrobatic Steps	summary: "Ignore 20 feet of difficult terrain when you move",
Persuasive	summary: "+2 bonus on Diplomacy and Intimidate checks",
Point-Blank Shot	summary: "+1 attack and damage on targets within 30 feet",
Far Shot	summary: "Decrease ranged penalties by half",
Precise Shot	summary: "No penalty for shooting into melee",
Improved Precise Shot	summary: "No cover or concealment chance on ranged attacks",
Pinpoint Targeting	summary: "No armor or shield bonus on one ranged attack",
Shot on the Run	summary: "Make ranged attack at any point during movement ",
Rapid Shot	summary: "Make one extra ranged attack",
Manyshot	summary: "Shoot two arrows simultaneously",
Power Attack	summary: "Trade melee attack bonus for damage",
Cleave	summary: "Make an additional attack if the first one hits",
Great Cleave	summary: "Make an additional attack after each attack hits",
Improved Bull Rush	summary: "+2 bonus on bull rush attempts, no attack of opportunity",
Greater Bull Rush	summary: "Enemies you bull rush provoke attacks of opportunity",
Improved Overrun	summary: "+2 bonus on overrun attempts, no attack of opportunity",
Greater Overrun	summary: "Enemies you overrun provoke attacks of opportunity",
Improved Sunder	summary: "+2 bonus on sunder attempts, no attack of opportunity",
Greater Sunder	summary: "Damage from sunder attempts transfers to your enemy",
Quick Draw	summary: "Draw weapon as a free action",
Rapid Reload	summary: "Reload crossbow quickly",
Run	summary: "Run at 5 times your normal speed",
Selective Channeling	summary: "Choose whom to affect with channel energy",
Self-Sufficient	summary: "+2 bonus on Heal and Survival checks",
Shield Proficiency	summary: "No penalties on attack rolls when using a shield",
Improved Shield Bash	summary: "Keep your shield bonus when shield bashing",
Shield Slam	summary: "Free bull rush with a bash attack ",
Shield Master	summary: "No two-weapon penalties when attacking with a shield",
Shield Focus	summary: "Gain a +1 bonus to your AC when using a shield",
Greater Shield Focus	summary: "Gain a +1 bonus to your AC when using a shield",
Tower Shield Proficiency	summary: "No penalties on attack rolls when using a tower shield",
Simple Weapon Proficiency	summary: "No penalty on attacks made with simple weapons",
Skill Focus	summary: "+3 bonus on one skill (+6 at 10 ranks)",
Spell Focus	summary: "+1 bonus on save DCs for one school",
Greater Spell Focus	summary: "+1 bonus on save DCs for one school",
Spell Mastery	summary: "Prepare some spells without a spellbook",
Spell Penetration	summary: "+2 bonus on level checks to beat spell resistance",
Greater Spell Penetration	summary: "+2 bonus on level checks to beat spell resistance",
Stealthy	summary: "+2 bonus on Escape Artist and Stealth checks",
Step Up	summary: "Take a 5-foot step as an immediate action",
Strike Back	summary: "Attack foes that strike you while using reach",
Throw Anything	summary: "No penalties for improvised ranged weapons",
Toughness	summary: "+3 hit points, +1 per Hit Die beyond 3",
Turn Undead	summary: "Channel energy can be used to make undead flee",
Two-Weapon Fighting	summary: "Reduce two-weapon fighting penalties",
Double Slice	summary: "Add your Str bonus to off-hand damage rolls",
Two-Weapon Rend	summary: "Rend a foe hit by both your weapons ",
Improved Two-Weapon Fighting	summary: "Gain additional off-hand attack ",	
Greater Two-Weapon Fighting	summary: "Gain a third off-hand attack  ",	
Two-Weapon Defense	summary: "Gain +1 shield bonus when fighting with two weapons",	
Vital Strike	summary: "Deal twice the normal damage on a single attack",	
Improved Vital Strike	summary: "Deal three times the normal damage on a single attack",	
Greater Vital Strike	summary: "6 Deal four times the normal damage on a single attack",	
Weapon Finesse	summary: "Use Dex instead of Str on attack rolls with light weapons",	
Weapon Focus	summary: "+1 bonus on attack rolls with one weapon ",	
Dazzling Display	summary: "Intimidate all foes within 30 feet",	
Shatter Defenses	summary: "Hindered foes are flat-footed",	
Deadly Stroke	summary: "Deal double damage plus 1 Con bleed ",	
Greater Weapon Focus	summary: "+1 bonus on attack rolls with one weapon",	
Penetrating Strike	summary: "Your attacks ignore 5 points of damage reduction",	
Greater Penetrating Strike	summary: "Your attacks ignore 10 points of damage reduction",	
Weapon Specialization	summary: "+2 bonus on damage rolls with one weapon",	
Greater Weapon Specialization	summary: "+2 bonus on damage rolls with one weapon ",	
Brew Potion	summary: "Create magic potions",
Craft Magic Arms and Armor	summary: "Create magic armors, shields, and weapons",
Craft Rod	summary: "Create magic rods",
Craft Staff	summary: "Create magic staves",
Craft Wand	summary: "Create magic wands",
Craft Wondrous Item	summary: "Create magic wondrous items",
Forge Ring	summary: "Create magic rings",
Scribe Scroll	summary: "Create magic scrolls",
Empower Spell	summary: "Increase spell variables by 50%",
Enlarge Spell	summary: "Double spell range",
Extend Spell	summary: "Double spell duration",
Heighten Spell	summary: "Treat spell as a higher level",
Maximize Spell	summary: "Maximize spell variables",
Quicken Spell	summary: "Cast spell as a swift action",
Silent Spell	summary: "Cast spell without verbal components",
Still Spell	summary: "Cast spell without somatic components",
Widen Spell	summary: "Double spell area",